ZONA V
../data/images/global_level.png
../data/images/parallax-1-800x200.png
../data/images/parallax-2-800x120.png
7 5
30 8

13 00 00 00 00 00 00 00 00 00 00 00 00 00 00 00 00 00 00 00 00 00 00 21 14 00 00 02 02 09
13 00 00 00 00 00 00 00 00 00 00 01 02 28 02 00 00 00 00 00 00 00 00 00 00 00 00 00 00 13
13 00 00 00 00 00 00 00 00 00 00 00 00 35 00 00 00 00 00 00 00 00 00 01 28 00 28 02 28 21
19 00 00 00 00 00 00 00 00 00 00 00 00 13 00 00 02 28 00 09 05 08 00 00 35 00 35 00 35 00
17 05 05 25 25 25 05 05 25 25 25 25 25 25 25 25 25 25 25 25 25 25 25 00 05 25 25 25 35 00
13 25 25 25 25 25 25 25 25 25 25 25 25 25 25 25 25 25 25 25 25 25 25 00 25 25 25 25 35 00
13 25 25 25 25 25 25 25 25 25 25 25 25 25 25 25 25 35 25 25 25 25 25 00 00 00 25 25 35 25
11 16 16 16 16 16 16 16 16 16 16 16 16 16 16 16 16 16 16 16 16 16 16 16 16 16 16 16 16 16

01 01 01 01 00 00 00 00 00 00 00 00 60 00 00 00 00 00 00 00 00 00 00 00 01 00 00 01 01 01
01 00 00 00 00 00 00 00 00 00 00 01 01 01 01 00 00 00 00 00 00 00 00 00 00 00 00 60 00 10
01 00 00 00 00 00 00 00 00 00 00 00 00 01 00 00 00 62 00 00 88 00 00 01 01 00 01 01 01 01
01 99 00 00 00 00 00 61 03 00 00 00 00 00 61 00 01 01 00 01 01 01 00 00 01 00 01 00 01 01
01 01 01 01 00 01 01 00 01 00 00 00 01 01 01 00 00 01 00 01 01 01 00 00 01 00 00 00 01 01
01 01 01 01 00 01 01 00 01 00 00 00 00 00 00 00 00 00 00 00 00 00 00 00 00 00 00 00 01 01
12 00 60 00 61 00 03 00 61 00 62 00 00 00 00 00 03 01 00 00 00 00 00 00 61 00 00 62 00 11
01 01 01 01 01 01 01 01 01 01 01 01 01 01 01 01 01 01 01 01 01 01 01 01 01 01 01 01 01 01

00 00 00 00 00 00 00 00 00 00 00 00 00 00 00 00 00 00 00 00 00 00 00 00 00 00 00 00 00 00
00 00 00 00 00 00 00 00 00 00 00 00 00 00 00 04 00 00 00 00 00 00 00 00 24 00 00 00 00 27
00 00 00 00 00 00 00 00 00 00 00 00 00 00 00 00 00 00 00 00 29 00 00 00 00 00 00 00 34 00
00 00 00 24 00 00 24 00 22 00 00 00 00 24 00 00 00 00 00 00 00 00 00 00 00 00 00 00 00 00
00 34 00 08 00 09 05 00 08 00 00 00 02 28 02 00 00 35 00 21 14 32 00 25 00 00 00 00 25 25
00 12 14 32 00 21 12 14 32 00 00 00 00 35 00 00 00 35 00 00 00 00 00 25 26 00 00 00 25 25
07 00 00 00 00 00 22 00 00 00 00 00 00 35 25 25 22 24 25 25 00 24 00 25 25 25 00 00 24 27
00 34 00 00 00 00 00 00 00 00 00 00 00 00 00 00 00 00 00 00 00 00 00 00 00 00 00 00 34 00

3
10 ../data/mainlevel-level1.lev
11 ../data/levels/level3.lev
12 ../data/levels/level2.lev